┏━━━━━━━━━━━━━━━━┓
┃                ┃
┃                ┃
┃                ┃
┃                ┃
┃                ┃
┃                ┃
┗━━━━━━━━━━━━━━━━┛